*ENGLISH PREMIER LEAGUE==ENGLISH PREMIER LEAGUE
*GERMANY-BUNDESLIGA I==GERMANY BUNDESLIGA
GERMANY BUNDESLIGA 2==GERMANY BUNDESLIGA 2
*ITALY SERIE A==ITALY SERIE A
ITALY SERIE B==ITALY SERIE B
*SPAIN PRIMERA LALIGA==SPAIN LA LIGA
UEFA CHAMPIONS LEAGUE==UEFA CHAMPIONS LEAGUE
2013 AFRICA CUP OF NATIONS (IN SOUTH AFRICA)==CAF AFRICAN CUP OF NATIONS 2013 (IN SOUTH AFRICA)
AFC CHALLENGE CUP QUALIFIERS==AFC Challenge Cup 2014 Qualifiers
ALGERIA 1ST DIVISION==ALGERIA PROFESSIONAL LIGUE 1
AUSTRALIA A-LEAGUE==AUSTRALIA HYUNDAI A LEAGUE
AUSTRALIA NEW SOUTH WALES PRESEASON CUP==AUSTRALIA NEW SOUTH WALES PRESEASON CUP
AUSTRIA TIPP3 BUNDESLIGA==AUSTRIA TIPP3 BUNDESLIGA
BELGIUM BELGACOM LEAGUE==BELGIUM 2ND DIV
BELGIUM JUPILER PRO LEAGUE==BELGIUM JUPILER PRO LEAGUE
BOLIVIA PROFESSIONAL FOOTBALL LEAGUE==BOLIVIA PROFESSIONAL FOOTBALL LEAGUE
BRAZIL CAMPEONATO CARIOCA==BRAZIL CARIOCA
BRAZIL CAMPEONATO PAULISTA==BRAZIL PAULISTA
CHILE PRIMERA DIVISION==CHILE PETROBRAS PRIMERA DIVISION
CLUB FRIENDLY==CLUB FRIENDLY
COLOMBIA CUP==COLOMBIA CUP
COLOMBIA PRIMERA A==COLOMBIA LIGA POSTOBON
CONCACAF CHAMPIONSHIP U20 (IN MEXICO)==CONCACAF U20 Championship (in Mexico)
COPA LIBERTADORES==COPA BRIDGESTONE LIBERTADORES
COPA DEL SOL (IN SPAIN)==COPA DEL SOL (IN SPAIN)
COSTA RICA PRIMERA DIVISION==COSTA RICA CAMPEONATO PRIMERA DIVISION
CROATIA 1ST DIVISION==Croatia Prva Liga
CYPRUS 1ST DIVISION==CYPRUS 1ST DIV
CYPRUS CUP==Cyprus Cup
CZECH REPUBLIC GAMBRINUS LEAGUE==Czech Republic Gambrinus Liga
DENMARK SUPER LEAGUE==DENMARK SUPER LEAGUE
DESERT DIAMOND CUP ( IN USA)==DESERT DIAMOND CUP (IN USA)
ECUADOR SERIE A==ECUADOR COPA PILSENER SERIE A
EGYPT LEAGUE==EGYPT PREMIER LEAGUE
ENGLAND FA CUP==ENGLISH FA CUP
ENGLISH CAPITAL ONE CUP==ENGLISH CAPITAL ONE CUP
ENGLISH CONFERENCE NATIONAL==English Conference National
ENGLISH CONFERENCE NORTH==ENGLISH CONFERENCE NORTH
ENGLISH CONFERENCE SOUTH==ENGLISH CONFERENCE SOUTH
ENGLISH FA TROPHY==ENGLISH FA TROPHY
ENGLISH JOHNSTONES PAINT TROPHY==ENGLISH JOHNSTONES PAINT TROPHY
ENGLISH LEAGUE CHAMPIONSHIP==ENGLISH CHAMPIONSHIP
ENGLISH LEAGUE ONE==ENGLISH NPOWER LEAGUE ONE
ENGLISH LEAGUE TWO==ENGLISH NPOWER LEAGUE TWO
FINLAND LEAGUE CUP==FINLAND LEAGUE CUP
FRANCE CUP==FRANCE CUP
FRANCE LIGUE 1==FRANCE LIGUE 1
FRANCE LIGUE 2==FRANCE LIGUE 2
FRANCE NATIONAL==FRANCE NATIONAL
GERMANY CUP==GERMANY CUP
GERMANY 3RD LIGA==GERMANY 3RD LEAGUE
GERMANY REGIONAL LEAGUE WEST==Germany Regional League West
GERMANY U19 LEAGUE==Germany 3rd League
GREECE SUPER LEAGUE==GREECE SUPER LEAGUE
HOLLAND BELOFTEN LEAGUE==Holland Beloften
HOLLAND CUP==Holland Cup
HOLLAND EREDIVISIE==HOLLAND EREDIVISIE
INTERNATIONAL FRIENDLY==INTERNATIONAL FRIENDLY
INTERNATIONAL FRIENDLY WOMEN==INTERNATIONAL FRIENDLY WOMEN
IRAN PRO LEAGUE==Iran Pro League
ISRAEL WINNER LEAGUE==ISRAEL PREMIER LEAGUE
ITALY LEGA PRO 1A==Italy Lega Pro 1A
ITALY LEGA PRO 1B==Italy Lega Pro 1B
INDONESIA SUPER LIGA==Indonesia Super League
MEXICO PRIMERA DIVISION==MEXICO PRIMERA DIVISION
NEW ZEALAND ASB PREMIERSHIP==NEW ZEALAND ASB PREMIERSHIP
NORTHERN IRELAND DANSKE BANK PREMIERSHIP==NORTHERN IRELAND DANSKE BANK PREMIERSHIP
POLAND EKSTRAKLASA==Poland Ekstraklasa
PORTUGAL SUPERLIGA==PORTUGAL LIGA ZON SAGRES
PORTUGAL SEGUNDA LIGA==Portugal Segunda Liga
ROMANIA 1ST DIVISION==Romania Liga 1 Bergenbier
RUSSIA PREMIER LEAGUE==Russia Premier League
SCOTLAND DIVISION 1==SCOTLAND IRN-BRU 1ST DIV
SCOTLAND DIVISION 2==SCOTLAND IRN-BRU 2ND DIV
SCOTLAND DIVISION 3==SCOTLAND IRN-BRU 3RD DIV
SCOTLAND FA CUP==SCOTLAND FA CUP
SCOTLAND PREMIER LEAGUE==SCOTLAND CLYDESDALE BANK PREMIER LEAGUE
SPAIN CUP==SPAIN CUP
SPAIN LIGA ADELANTE==SPAIN LIGA ADELANTE
SWITZERLAND CHALLENGE LEAGUE==Swiss Challenge League
SWITZERLAND SUPER LEAGUE==SWISS RAIFFEISEN SUPER LEAGUE
SWEDEN ALLSVENSKAN==SWEDEN ALLSVENSKAN
TURKEY CUP==Turkey Cup
TURKEY FIRST LEAGUE==TURKEY 1ST LIG
TURKEY SUPER LEAGUE==TURKEY SUPER LEAGUE
VENEZUELA PRIMERA DIVISION==VENEZUELA COPA MOVILNET
UEFA EUROPA LEAGUE==UEFA EUROPA LEAGUE
UAE ETISALAT PRO LEAGUE==UAE Etisalat Pro League
USA MAJOR LEAGUE SOCCER==USA Major League Soccer
WALES CORBETT SPORTS PREMIER LEAGUE==WALES PREMIER LEAGUE
WALT DISNEY WORLD PRO SOCCER CLASSIC==WALT DISNEY WORLD PRO SOCCER CLASSIC (IN USA)